# Boulderoid v1.15
author Fernando Herrera
name AUTOBAN
intermission
width 40
height 22
mapstart
WWWWWWWWWWWWWWWWWWWWWWWWWWWWWWWWWWWWWWWW
WP.   c  c  c    .XWWWWWWWWWWWWWWWWWWWWW
W.. ............ ..WWWWWWWWWWWWWWWWWWWWW
W.. .          .c..WWWWWWWWWWWWWWWWWWWWW
W..c.          . ..WWWWWWWWWWWWWWWWWWWWW
W.. .          .c..WWWWWWWWWWWWWWWWWWWWW
W..c.  dddddd  . ..WWWWWWWWWWWWWWWWWWWWW
W.. . ........ . ..WWWWWWWWWWWWWWWWWWWWW
W..c.          .c..WWWWWWWWWWWWWWWWWWWWW
W.. ............ ..WWWWWWWWWWWWWWWWWWWWW
W..    c c  c    ..WWWWWWWWWWWWWWWWWWWWW
WWWWWWWWWWWWWWWWWWWWWWWWWWWWWWWWWWWWWWWW
WWWWWWWWWWWWWWWWWWWWWWWWWWWWWWWWWWWWWWWW
WWWWWWWWWWWWWWWWWWWWWWWWWWWWWWWWWWWWWWWW
WWWWWWWWWWWWWWWWWWWWWWWWWWWWWWWWWWWWWWWW
WWWWWWWWWWWWWWWWWWWWWWWWWWWWWWWWWWWWWWWW
WWWWWWWWWWWWWWWWWWWWWWWWWWWWWWWWWWWWWWWW
WWWWWWWWWWWWWWWWWWWWWWWWWWWWWWWWWWWWWWWW
WWWWWWWWWWWWWWWWWWWWWWWWWWWWWWWWWWWWWWWW
WWWWWWWWWWWWWWWWWWWWWWWWWWWWWWWWWWWWWWWW
WWWWWWWWWWWWWWWWWWWWWWWWWWWWWWWWWWWWWWWW
WWWWWWWWWWWWWWWWWWWWWWWWWWWWWWWWWWWWWWWW
mapend
noscroll
delay 30
time 20
require 6
dpoints 99
dextra 0
permeable 9
amrate1 1
amoeba 23
milltime 999
colour1 0
colour2 0
colour3 9
colour4 6
colour5 5
timepercent 100
teleport 1234567890,YYYYYYYYYY,NNNNNNNNNN