# Boulderoid v1.15
author Fernando Herrera
name BLAST
width 40
height 22
mapstart
WWWWWWWWWWWWWWWWWWWWWWWWWWWWWWWWWWWWWWWW
WP.Xw..rw..rw..rw..rw..rw..rw..rw..rw..W
W...w...w...w...w...w...w...w...w...w..W
W.wrw.wrw.wrw.wrw.wrw.wrw.wrw.wrw.wrwr.W
W...w...w...w...w...w...w...W...w...w..W
W   w   w   w   W   w   w   W   W . w..W
WQ. w . w . w . W . w . w . W . W . w..W
W . w . w . w . W . w . w . W . W . w..W
W . w . w . wQ. W . w . W . W . W . w..W
W . w . W . w . W . w . WQ. w . W . w..W
W . wQ. W . w . W . W . W . w . WQ. W..W
W . w . WQ. w . w . W . W . w . W . W..W
W . w . W . w . w . WQ. W . w . W . W  W
W . w . w . W . wQ. W . w . wQ. W . W  W
W . w . w . W . w . W . w . w . W . Wc W
W . w . w . W . w . W . w . w . W . W  W
W . w . w . W . w . W . w . w . w . W  W
W . w . w . W . w . w . w . W . w . W  W
W . w . w . W . w . w . W . W . w . W  W
W . w . w . w . w . w . W . W . w . W  W
W   w   w   w   w   w   W   W   w   W  W
WWWWWWWWWWWWWWWWWWWWWWWWWWWWWWWWWWWWWWWW
mapend
delay 0
time 226
require 3
dpoints 99
dextra 99
permeable 9
amrate1 1
amoeba 23
milltime 999
colour1 0
colour2 0
colour3 4
colour4 11
colour5 7
timepercent 100
teleport 1234567890,YYYYYYYYYY,NNNNNNNNNN