# Boulderoid v1.15
author Brett Allen
name CHASE
intermission
width 40
height 22
mapstart
WWWWWWWWWWWWWWWWWWWWWWWWWWWWWWWWWWWWWWWW
W...r ............mWWWWWWWWWWWWWWWWWWWWW
W.mm. mmmmmmmmmm..rWWWWWWWWWWWWWWWWWWWWW
W.m..w.........rm..WWWWWWWWWWWWWWWWWWWWW
W...mr..mmmmm...m.mWWWWWWWWWWWWWWWWWWWWW
Wm..m..m.c   m..m. WWWWWWWWWWWWWWWWWWWWW
W..rm..mP... m..mr.WWWWWWWWWWWWWWWWWWWWW
W....m..m..  m.rm..WWWWWWWWWWWWWWWWWWWWW
W..m..m.... m...mm.WWWWWWWWWWWWWWWWWWWWW
W.mm...mmmmm....m .WWWWWWWWWWWWWWWWWWWWW
W.............mmm..XWWWWWWWWWWWWWWWWWWWW
WWWWWWWWWWWWWWWWWWWWWWWWWWWWWWWWWWWWWWWW
WWWWWWWWWWWWWWWWWWWWWWWWWWWWWWWWWWWWWWWW
WWWWWWWWWWWWWWWWWWWWWWWWWWWWWWWWWWWWWWWW
WWWWWWWWWWWWWWWWWWWWWWWWWWWWWWWWWWWWWWWW
WWWWWWWWWWWWWWWWWWWWWWWWWWWWWWWWWWWWWWWW
WWWWWWWWWWWWWWWWWWWWWWWWWWWWWWWWWWWWWWWW
WWWWWWWWWWWWWWWWWWWWWWWWWWWWWWWWWWWWWWWW
WWWWWWWWWWWWWWWWWWWWWWWWWWWWWWWWWWWWWWWW
WWWWWWWWWWWWWWWWWWWWWWWWWWWWWWWWWWWWWWWW
WWWWWWWWWWWWWWWWWWWWWWWWWWWWWWWWWWWWWWWW
WWWWWWWWWWWWWWWWWWWWWWWWWWWWWWWWWWWWWWWW
mapend
noscroll
delay 20
time 15
require 1
dpoints 25
dextra 50
permeable 9
amrate1 1
amoeba 23
milltime 2
colour1 2
colour2 2
colour3 15
colour4 10
colour5 7
timepercent 100
teleport 1234567890,YYYYYYYYYY,NNNNNNNNNN