# Boulderoid v1.15
author Brett Allen
name CHECK
intermission
width 40
height 22
mapstart
WWWWWWWWWWWWWWWWWWWWWWWWWWWWWWWWWWWWWWWW
W...r..r....r..r...WWWWWWWWWWWWWWWWWWWWW
W..................WWWWWWWWWWWWWWWWWWWWW
W..................WWWWWWWWWWWWWWWWWWWWW
WP.. wmmmwwwwww ..XWWWWWWWWWWWWWWWWWWWWW
WQ.. wa awxa aw ..QWWWWWWWWWWWWWWWWWWWWW
W .. w a ww a w .. WWWWWWWWWWWWWWWWWWWWW
W .. wa awxa aw .. WWWWWWWWWWWWWWWWWWWWW
W .. w a ww a w .. WWWWWWWWWWWWWWWWWWWWW
W .. wa awxa aw .. WWWWWWWWWWWWWWWWWWWWW
W    wwwwwwwwww    WWWWWWWWWWWWWWWWWWWWW
WWWWWWWWWWWWWWWWWWWWWWWWWWWWWWWWWWWWWWWW
WWWWWWWWWWWWWWWWWWWWWWWWWWWWWWWWWWWWWWWW
WWWWWWWWWWWWWWWWWWWWWWWWWWWWWWWWWWWWWWWW
WWWWWWWWWWWWWWWWWWWWWWWWWWWWWWWWWWWWWWWW
WWWWWWWWWWWWWWWWWWWWWWWWWWWWWWWWWWWWWWWW
WWWWWWWWWWWWWWWWWWWWWWWWWWWWWWWWWWWWWWWW
WWWWWWWWWWWWWWWWWWWWWWWWWWWWWWWWWWWWWWWW
WWWWWWWWWWWWWWWWWWWWWWWWWWWWWWWWWWWWWWWW
WWWWWWWWWWWWWWWWWWWWWWWWWWWWWWWWWWWWWWWW
WWWWWWWWWWWWWWWWWWWWWWWWWWWWWWWWWWWWWWWW
WWWWWWWWWWWWWWWWWWWWWWWWWWWWWWWWWWWWWWWW
mapend
noscroll
delay 25
time 45
require 32
dpoints 10
dextra 0
permeable 9
amrate1 85
amoeba 23
milltime 1
colour1 0
colour2 0
colour3 9
colour4 4
colour5 5
timepercent 100
teleport 1234567890,YYYYYYYYYY,NNNNNNNNNN