# Boulderoid v1.15
author Grant Walker
name CROSS
intermission
width 40
height 22
mapstart
WWWWWWWWWWWWWWWWWWWWWWWWWWWWWWWWWWWWWWWW
W........QQQQQQQ...WWWWWWWWWWWWWWWWWWWWW
W........QcccccQ...WWWWWWWWWWWWWWWWWWWWW
W........Qc...cQ...WWWWWWWWWWWWWWWWWWWWW
W........Qc.a.cQ...WWWWWWWWWWWWWWWWWWWWW
W........Qc...cQ...WWWWWWWWWWWWWWWWWWWWW
W........QcccccQ...WWWWWWWWWWWWWWWWWWWWW
W........QQQQQQQ...WWWWWWWWWWWWWWWWWWWWW
W..................WWWWWWWWWWWWWWWWWWWWW
WP.................WWWWWWWWWWWWWWWWWWWWW
WX.................WWWWWWWWWWWWWWWWWWWWW
WWWWWWWWWWWWWWWWWWWWWWWWWWWWWWWWWWWWWWWW
WWWWWWWWWWWWWWWWWWWWWWWWWWWWWWWWWWWWWWWW
WWWWWWWWWWWWWWWWWWWWWWWWWWWWWWWWWWWWWWWW
WWWWWWWWWWWWWWWWWWWWWWWWWWWWWWWWWWWWWWWW
WWWWWWWWWWWWWWWWWWWWWWWWWWWWWWWWWWWWWWWW
WWWWWWWWWWWWWWWWWWWWWWWWWWWWWWWWWWWWWWWW
WWWWWWWWWWWWWWWWWWWWWWWWWWWWWWWWWWWWWWWW
WWWWWWWWWWWWWWWWWWWWWWWWWWWWWWWWWWWWWWWW
WWWWWWWWWWWWWWWWWWWWWWWWWWWWWWWWWWWWWWWW
WWWWWWWWWWWWWWWWWWWWWWWWWWWWWWWWWWWWWWWW
WWWWWWWWWWWWWWWWWWWWWWWWWWWWWWWWWWWWWWWW
mapend
noscroll
delay 35
time 30
require 20
dpoints 10
dextra 50
permeable 8
amrate1 100
amoeba 23
milltime 999
colour1 5
colour2 5
colour3 7
colour4 4
colour5 0
timepercent 100
teleport 1234567890,YYYYYYYYYY,NNNNNNNNNN