# Boulderoid v1.15
author Fernando Herrera
name DROP
intermission
width 40
height 22
mapstart
WWWWWWWWWWWWWWWWWWWWWWWWWWWWWWWWWWWWWWWW
WPr..............rXWWWWWWWWWWWWWWWWWWWWW
W.....r.r.r.r.r....WWWWWWWWWWWWWWWWWWWWW
Www  wwwwwwwwwww  wWWWWWWWWWWWWWWWWWWWWW
Wwww             wwWWWWWWWWWWWWWWWWWWWWW
Wwwww           wwwWWWWWWWWWWWWWWWWWWWWW
Wwwwww         wwwwWWWWWWWWWWWWWWWWWWWWW
Wwwwwww       wwwwwWWWWWWWWWWWWWWWWWWWWW
W                  WWWWWWWWWWWWWWWWWWWWW
W wwwwwwwwwwwwwwww WWWWWWWWWWWWWWWWWWWWW
W  c       c     c WWWWWWWWWWWWWWWWWWWWW
WWWWWWWWWWWWWWWWWWWWWWWWWWWWWWWWWWWWWWWW
WWWWWWWWWWWWWWWWWWWWWWWWWWWWWWWWWWWWWWWW
WWWWWWWWWWWWWWWWWWWWWWWWWWWWWWWWWWWWWWWW
WWWWWWWWWWWWWWWWWWWWWWWWWWWWWWWWWWWWWWWW
WWWWWWWWWWWWWWWWWWWWWWWWWWWWWWWWWWWWWWWW
WWWWWWWWWWWWWWWWWWWWWWWWWWWWWWWWWWWWWWWW
WWWWWWWWWWWWWWWWWWWWWWWWWWWWWWWWWWWWWWWW
WWWWWWWWWWWWWWWWWWWWWWWWWWWWWWWWWWWWWWWW
WWWWWWWWWWWWWWWWWWWWWWWWWWWWWWWWWWWWWWWW
WWWWWWWWWWWWWWWWWWWWWWWWWWWWWWWWWWWWWWWW
WWWWWWWWWWWWWWWWWWWWWWWWWWWWWWWWWWWWWWWW
mapend
noscroll
delay 25
time 30
require 6
dpoints 80
dextra 99
permeable 9
amrate1 1
amoeba 23
milltime 25
colour1 0
colour2 0
colour3 10
colour4 11
colour5 3
timepercent 100
teleport 1234567890,YYYYYYYYYY,NNNNNNNNNN