# Boulderoid v1.15
author PL
name Cave E
width 40
height 22
mapstart
WWWWWWWWWWWWWWWWWWWWWWWWWWWWWWWWWWWWWWWW
WP.....................................W
W......................................W
W......................................W
W......................................W
W......................................W
W......................................W
W......................................W
W.......  O.....  O.....  O.....  O....W
W.......   .....   .....   .....   ....W
W....... d ..... d ..... d ..... d ....W
W......................................W
W......................................W
W......................................W
W.......  O.....  O.....  O.....  O....W
W.......   .....   .....   .....   ....W
W....... d ..... d ..... d ..... d ....W
W......................................W
W......................................W
W......................................W
W......................................X
WWWWWWWWWWWWWWWWWWWWWWWWWWWWWWWWWWWWWWWW
mapend
delay 40
time 150
require 4
dpoints 50
dextra 90
permeable 7
amrate1 3
amoeba 23
milltime 20
colour1 0
colour2 0
colour3 9
colour4 4
colour5 1
timepercent 100
teleport 1234567890,YYYYYYYYYY,NNNNNNNNNN