# Boulderoid v1.15
author Brett Allen
name GUARD
intermission
width 40
height 22
mapstart
WWWWWWWWWWWWWWWWWWWWWWWWWWWWWWWWWWWWWWWW
W..Q            Q..WWWWWWWWWWWWWWWWWWWWW
W.. ............ ..WWWWWWWWWWWWWWWWWWWWW
WW. .Q        Q. .HWWWWWWWWWWWWWWWWWWWWW
W.. . ........ . ..WWWWWWWWWWWWWWWWWWWWW
W.. . .dddddd. . ..WWWWWWWWWWWWWWWWWWWWW
WP. . .dddddd. . .WWWWWWWWWWWWWWWWWWWWWW
W.. . ........ . ..WWWWWWWWWWWWWWWWWWWWW
W.. .Q        Q. ..WWWWWWWWWWWWWWWWWWWWW
WW. ............ .WWWWWWWWWWWWWWWWWWWWWW
W..Q            Q..WWWWWWWWWWWWWWWWWWWWW
WWWWWWWWWWWWWWWWWWWWWWWWWWWWWWWWWWWWWWWW
WWWWWWWWWWWWWWWWWWWWWWWWWWWWWWWWWWWWWWWW
WWWWWWWWWWWWWWWWWWWWWWWWWWWWWWWWWWWWWWWW
WWWWWWWWWWWWWWWWWWWWWWWWWWWWWWWWWWWWWWWW
WWWWWWWWWWWWWWWWWWWWWWWWWWWWWWWWWWWWWWWW
WWWWWWWWWWWWWWWWWWWWWWWWWWWWWWWWWWWWWWWW
WWWWWWWWWWWWWWWWWWWWWWWWWWWWWWWWWWWWWWWW
WWWWWWWWWWWWWWWWWWWWWWWWWWWWWWWWWWWWWWWW
WWWWWWWWWWWWWWWWWWWWWWWWWWWWWWWWWWWWWWWW
WWWWWWWWWWWWWWWWWWWWWWWWWWWWWWWWWWWWWWWW
WWWWWWWWWWWWWWWWWWWWWWWWWWWWWWWWWWWWWWWW
mapend
noscroll
delay 10
time 10
require 10
dpoints 15
dextra 50
permeable 9
amrate1 1
amoeba 23
milltime 999
colour1 0
colour2 0
colour3 9
colour4 5
colour5 1
timepercent 100
teleport 1234567890,YYYYYYYYYY,NNNNNNNNNN