# Boulderoid v1.15
author Grant Walker
name HARDIE
width 40
height 22
mapstart
WWWWWWWWWWWWWWWWWWWWWWWWWWWWWWWWWWWWWWWW
W                                     aW
W HHHHHHHHHHHHHHHHHHHHHHHHHHHHHHHHHHHHWW
W HHHHHHHHHHHHHHHHHHHHHHHHHHHHHHHHHHHH W
W HHHHHHHHHHHHHHHHHHHHHHHHHHHHHHHHHcHH W
W HHHHHHHHHHHHHHHHHHHHHHHHHHHHHHHHH HH W
W HQQQQQHr    HaHaHaHaH        HHHHdHH W
W HQWWWQH..   PaHaHaHaH        HHHH.HH W
W HQWWWQH .   HaHaHaHaHHHHHddddHHHH HH W
W HddWWQH .   HaHaHaHaHHHHHddddHHHH HH W
W HWWWW H .   HaHaHaHaHHHHHddddHH   HH W
W HQWWWQH .   HaHaHaHaHHHHHddddHH H  H W
W HQWWWQH rrr HaHaHaHaHHHHHddddHH   HH W
W HQQQQQHQ... HaHaHaHaHHHHHddddHHHH HH W
W HHHHHHHHw wHHaHaHaHaHHHHHddddHHHH HH W
W HHHHHHHHH HHHHHHHHHHHrHHHHHHHHHHH HH W
W HHHHHHHHH HHHHHHHHHHH.  HHHHHHHHH HH W
W HHHHHHHHH HHHHHHHHHHH HHHHHHHHHHH HH W
W HHHHHHHH                          HH W
W HHHHHHHHHHHHHHHHHHHHHHHHHHHHHHHHHHHH W
W                                      W
WWWWWWWWWWWWWWWWWWWWWWWWWWWWWWWWWWWWWWWW
mapend
delay 45
time 100
require 40
dpoints 10
dextra 0
permeable 9
amrate1 1
amoeba 23
milltime 1
colour1 0
colour2 0
colour3 5
colour4 5
colour5 2
timepercent 100
teleport 1234567890,YYYYYYYYYY,NNNNNNNNNN