# Boulderoid v1.15
author Ian Bradtke
name IANFIRST
width 40
height 22
mapstart
WWWWWWWWWWWWWWWWWWWWWWWWWWWWWWWWWWWWWWWW
W.....r....r..r........................W
W...... .. .. .........................W
W......Q..Q..Q.............r...........W
Wr...d.....................ddddddr.....W
W.....wwwwwwwww........................W
W.....wP......w...........wmmmmmmmw....W
W..   w.WWWWW.w..r......r.w       w....W
W.. rQw.WdHdW.w...........w       w.r..W
W.. . w.......wc.......c..w       w....W
W..   w.......wdwwwwwwwdwwwc     cw....W
W.... w.. . ..w...w...w...w       w....W
W.... w  c.c  w.w.w.w.w.w.wc     cw....W
W.....wxxxxxwww.w.w.w.w.w.w  c c  w....W
W.........r...w.w.w.w.w.w.wwwwwwwww....W
W.............w.w.w.w.w.w.w............W
W.c      .....w.w.w.w.w.w.w......r.....W
W.............w.w.w.w.w.w.w............W
W.......rr....w.w.w.w.w.w.w......QQ....W
W.............w.w.w.w.w.w.w............W
W.wr............w...w...w........cc....W
WWWWWWWWWWWWWWWWWWWWWWWWWWWWWWWWWWWWWWWW
mapend
delay 30
time 200
require 58
dpoints 10
dextra 50
permeable 9
amrate1 1
amoeba 23
milltime 239
colour1 0
colour2 0
colour3 8
colour4 14
colour5 7
timepercent 100
teleport 1234567890,YYYYYYYYYY,NNNNNNNNNN