# Boulderoid v1.15
author Brett Allen
name QUICKY
intermission
width 40
height 22
mapstart
WWWWWWWWWWWWWWWWWWWWWWWWWWWWWWWWWWWWWWWW
WP...w.Q..r....wd.XWWWWWWWWWWWWWWWWWWWWW
W....wd.......rwr..WWWWWWWWWWWWWWWWWWWWW
W..r.wr.......dw...WWWWWWWWWWWWWWWWWWWWW
W....w....mr..rw..rWWWWWWWWWWWWWWWWWWWWW
Wr.d.w....w....w...WWWWWWWWWWWWWWWWWWWWW
W.r..wd.rQw....wr..WWWWWWWWWWWWWWWWWWWWW
W....w....w...Qw...WWWWWWWWWWWWWWWWWWWWW
W.dr.w...rw.r. w..QWWWWWWWWWWWWWWWWWWWWW
W....d....w... r.drWWWWWWWWWWWWWWWWWWWWW
WQ...r.r..w.d..r...WWWWWWWWWWWWWWWWWWWWW
WWWWWWWWWWWWWWWWWWWWWWWWWWWWWWWWWWWWWWWW
WWWWWWWWWWWWWWWWWWWWWWWWWWWWWWWWWWWWWWWW
WWWWWWWWWWWWWWWWWWWWWWWWWWWWWWWWWWWWWWWW
WWWWWWWWWWWWWWWWWWWWWWWWWWWWWWWWWWWWWWWW
WWWWWWWWWWWWWWWWWWWWWWWWWWWWWWWWWWWWWWWW
WWWWWWWWWWWWWWWWWWWWWWWWWWWWWWWWWWWWWWWW
WWWWWWWWWWWWWWWWWWWWWWWWWWWWWWWWWWWWWWWW
WWWWWWWWWWWWWWWWWWWWWWWWWWWWWWWWWWWWWWWW
WWWWWWWWWWWWWWWWWWWWWWWWWWWWWWWWWWWWWWWW
WWWWWWWWWWWWWWWWWWWWWWWWWWWWWWWWWWWWWWWW
WWWWWWWWWWWWWWWWWWWWWWWWWWWWWWWWWWWWWWWW
mapend
noscroll
delay 25
time 30
require 10
dpoints 25
dextra 0
permeable 9
amrate1 1
amoeba 23
milltime 1
colour1 0
colour2 0
colour3 6
colour4 12
colour5 3
timepercent 100
teleport 1234567890,YYYYYYYYYY,NNNNNNNNNN