# Boulderoid v1.15
author Fernando Herrera
name RESCUE
width 40
height 22
mapstart
WWWWWWWWWWWWWWWWWWWWWWWWWWWWWWWWWWWWWWWW
W......................................W
W....................................r.W
W.x..w..x...................w..........W
W.x..w..x...................w..www..xx.W
W.x..w..x...................   ......w.W
W.x..w..x............wwwwx..Q. ......w.W
W.x..w..x.......xxww........   ......w.W
W.x..w..x..   ...    ................w.W
W.x..w..x..Q. ...Q.. ................w.W
W.x........   ...    ...............w..W
W.x..............    ...............w.XW
W.....................wwwwwwwwwwwwwww.xW
W.x.w.w.x.x.w.xx...w...................W
W...............   w...................W
WP..............   w...................W
W...............Q. w...................W
W...............   ....................W
W.   ..................................W
W.Q. ..................................W
Wd   ..................................W
WWWWWWWWWWWWWWWWWWWWWWWWWWWWWWWWWWWWWWWW
mapend
delay 45
time 200
require 1
dpoints 99
dextra 99
permeable 9
amrate1 1
amoeba 23
milltime 999
colour1 0
colour2 0
colour3 4
colour4 6
colour5 5
timepercent 100
teleport 1234567890,YYYYYYYYYY,NNNNNNNNNN