# Boulderoid v1.15
author Grant Walker
name TWINS
width 40
height 22
mapstart
WWWWWWWWWWWWWWWWWWWWWWWWWWWWWWWWWWWWWWWW
WrXr.........c. .......................W
W.r.......... .c.......................W
WWWWWWWWWWWWWWWWWWWWWWWWWWWWWWWWWWWWWW.W
WrH.................................rrrW
W.H................................rP.PW
W.WWWWWWWWWWWWWWWWWWWWWWWWWWWWWWWWWWWWWW
W......................................W
W......................................W
WWWWWWWWWWWWWWWWWWWWWWWWWWWWWWWWWWWWWW.W
W..r...................................W
W.rPr..................................W
W.WWWWWWWWWWWWWWWWWWWWWWWWWWWWWWWWWWWWWW
W..................................r.wcW
W..................................rPw.W
WWWWWWWWWWWWWWWWWWWWWWWWWWWWWWWWWWWWWW.W
W.H.r..................................W
WcH.r..................................W
W.WWWWWWWWWWWWWWWWWWWWWWWWWWWWWWWWWWWWWW
W......................................W
WP....................................PW
WWWWWWWWWWWWWWWWWWWWWWWWWWWWWWWWWWWWWWWW
mapend
delay 30
time 100
require 22
dpoints 10
dextra 1
permeable 9
amrate1 1
amoeba 23
milltime 999
colour1 0
colour2 0
colour3 10
colour4 11
colour5 7
timepercent 100
teleport 1234567890,YYYYYYYYYY,NNNNNNNNNN